######
#    #
# #  #
#  # #
#  # #
######